BBBBBBBBBBBBBBBBBBBBBBBBBBBBBBBBBBBBBBBB
B                                B     B
B                                B     B
B                                B     B
B                                B     B
B       0000                 BBBBB     B
B                                B     B
BBBBB                            B     B
B        BB                      BB    B
B        BB                            B
B        BB             BB             B
BBBBBBBBBBBBBB        BBBBBBBBBBBBBBBBBB
